32
7 31 31 31 31 31 31 31 29 25 23 31 31 31 17 29 19 23 31 31 31 31 31 31 31 31 31 31 31 31 31 28 
199 255 255 255 255 253 245 247 254 0 207 255 255 114 175 94 0 233 255 255 255 255 255 255 255 253 249 241 247 255 255 124 
199 255 255 255 253 115 95 221 115 183 223 255 127 177 255 127 191 156 207 255 255 255 255 255 255 254 0 15 221 251 247 124 
199 255 255 253 114 135 255 127 29 246 225 247 127 191 222 239 253 248 207 255 255 255 255 249 240 109 181 215 254 0 227 116 
199 255 255 124 0 239 255 255 122 79 60 203 247 255 255 255 252 143 223 255 255 253 249 51 159 92 79 221 123 54 0 100 
199 255 255 120 135 223 255 243 191 253 240 0 239 255 255 255 255 223 255 255 255 252 0 143 255 255 221 252 0 111 60 68 
199 255 255 60 201 243 120 175 253 119 29 155 215 253 241 243 247 255 255 253 248 107 159 223 255 251 246 79 157 219 119 92 
199 255 255 255 31 159 191 221 120 199 252 0 231 124 0 0 239 255 253 249 151 158 239 247 251 54 239 253 248 0 237 116 
199 255 255 255 255 255 255 254 0 201 112 0 207 124 0 135 223 255 252 0 207 255 125 251 63 255 255 254 15 159 95 92 
199 255 255 253 246 225 247 127 191 30 0 143 223 124 2 199 255 253 120 135 223 255 255 157 251 255 253 251 255 255 255 124 
199 255 255 120 79 63 220 235 247 127 191 223 253 116 8 239 255 252 0 199 255 255 255 255 147 241 242 132 235 247 255 124 
199 255 255 191 221 243 247 31 243 254 235 255 127 223 159 223 255 126 0 197 249 255 253 123 51 63 31 254 0 237 247 124 
199 255 251 247 126 0 233 112 167 255 189 247 252 233 247 255 255 125 57 209 146 198 230 0 167 255 255 127 191 95 223 124 
199 255 53 251 119 189 26 0 201 243 115 223 253 19 215 255 255 254 0 0 0 104 105 61 215 255 255 255 255 255 255 124 
199 127 254 0 225 248 0 175 30 0 167 255 121 16 231 255 255 126 39 31 159 159 157 89 215 255 255 255 255 255 255 124 
199 255 127 63 158 0 143 223 127 60 199 253 58 0 207 255 255 125 243 255 255 255 252 0 199 255 253 249 255 255 255 124 
199 255 255 255 127 191 223 255 255 127 223 254 14 167 223 255 255 127 155 255 255 253 120 0 197 249 240 134 205 249 247 124 
199 249 241 241 245 245 247 255 255 255 255 255 127 255 255 255 255 255 189 243 247 252 0 15 221 27 23 223 255 30 205 116 
199 60 0 0 71 95 221 245 247 241 247 255 255 255 255 255 255 255 126 0 228 111 157 211 245 23 255 255 255 255 127 92 
197 117 21 29 219 247 127 95 95 63 223 255 255 255 255 255 255 255 127 62 207 223 126 0 110 207 255 255 255 255 253 116 
71 95 222 206 0 237 241 247 255 255 255 255 255 255 255 255 255 255 255 255 255 255 127 191 223 254 227 247 255 251 119 92 
199 252 225 127 191 95 31 223 255 255 255 255 255 255 255 255 255 255 255 255 255 255 255 255 255 127 61 245 253 55 255 124 
193 115 151 223 255 255 255 255 255 253 251 247 255 255 255 255 255 255 255 255 255 253 247 255 255 253 121 210 79 223 255 124 
6 0 224 231 255 255 255 255 253 246 0 239 255 255 255 255 255 255 255 255 255 127 211 255 255 248 0 143 255 255 255 124 
71 63 31 223 241 255 253 251 118 79 191 223 253 247 255 255 255 255 255 255 255 127 188 229 244 47 159 223 255 255 247 124 
199 255 253 123 183 223 254 0 239 253 255 253 118 199 255 255 255 255 255 255 255 255 127 95 223 223 255 253 253 118 239 124 
198 230 236 0 227 255 127 191 221 244 199 125 92 239 255 255 255 255 255 255 255 255 255 255 255 255 253 250 71 223 255 124 
71 255 127 31 159 255 255 253 119 93 217 246 207 223 255 255 255 255 255 255 255 255 255 255 255 255 254 0 231 253 249 116 
199 255 255 255 255 255 253 117 221 250 0 207 255 255 255 255 255 255 255 255 255 255 255 255 255 255 127 61 219 242 0 76 
199 255 255 255 255 255 127 222 198 15 191 223 255 255 255 255 255 255 255 255 255 255 255 255 255 255 255 255 31 63 191 92 
199 255 255 255 255 255 255 127 255 255 255 255 255 255 255 255 255 255 255 255 255 255 255 255 255 255 255 255 255 255 255 124 
193 241 241 241 241 241 241 241 241 241 241 241 241 241 241 241 241 241 241 241 241 241 241 241 241 241 241 241 241 241 241 112 
