32
7 31 31 31 31 31 31 31 29 29 31 31 31 31 19 29 27 31 31 31 31 31 31 31 31 31 31 31 31 31 31 28 
199 255 249 255 253 247 245 247 254 207 223 255 255 122 175 254 143 251 255 255 249 247 253 255 255 251 253 253 247 255 251 124 
199 254 175 217 125 91 127 221 243 247 255 255 255 177 255 255 255 188 237 251 55 223 247 221 244 175 248 77 217 243 183 124 
199 251 252 173 218 143 255 127 29 247 241 255 127 191 222 239 253 253 222 0 239 124 239 123 214 205 189 214 0 0 231 124 
199 189 255 222 135 255 255 255 122 79 190 207 255 253 255 255 254 199 93 191 209 253 215 55 255 252 79 93 57 23 220 108 
199 253 215 125 247 255 255 247 190 237 240 231 253 255 220 239 126 239 255 95 189 93 84 235 245 247 221 252 0 203 245 92 
199 125 215 124 201 243 122 237 245 127 31 223 253 213 241 211 243 253 246 239 249 91 222 0 111 223 246 79 156 0 231 92 
199 127 221 251 23 159 189 123 218 199 253 249 119 92 0 0 174 103 221 249 183 158 111 183 219 118 239 241 124 0 205 116 
197 254 226 0 239 252 239 159 62 237 242 0 207 127 22 135 93 255 254 0 207 249 127 251 63 255 125 186 77 155 95 92 
199 95 63 189 215 241 215 249 255 126 0 166 199 124 102 231 255 223 127 182 199 187 223 191 251 255 252 143 254 135 255 124 
199 255 255 121 95 63 222 171 223 127 62 79 253 116 73 255 255 253 120 109 255 191 253 247 179 245 242 204 107 255 255 124 
199 255 255 191 221 243 247 191 251 254 235 255 127 223 159 220 235 246 141 213 217 254 111 95 55 127 159 254 142 237 255 124 
199 255 251 247 126 0 233 244 175 255 189 247 252 233 247 254 0 239 125 209 146 198 238 97 247 253 247 251 255 255 219 124 
199 255 53 251 119 191 30 207 223 247 115 223 253 23 213 126 175 222 110 0 0 237 121 61 215 127 223 191 255 253 187 116 
199 127 254 0 229 251 240 239 126 103 183 255 125 81 247 223 255 254 111 61 157 219 159 93 223 253 255 254 237 254 0 108 
199 255 127 63 223 30 175 221 119 125 247 255 123 23 223 255 255 255 255 254 206 133 253 241 223 255 221 255 255 95 191 92 
199 255 255 255 255 255 255 127 215 127 223 254 46 231 255 255 255 255 251 255 119 253 88 135 213 249 244 206 237 249 255 124 
199 249 245 245 245 245 247 127 255 255 247 253 119 255 255 255 255 255 189 119 255 254 0 79 255 27 215 223 255 159 221 124 
199 60 70 64 71 95 221 245 247 117 247 127 223 255 255 255 255 255 126 199 246 111 189 219 245 55 255 255 255 255 255 92 
197 119 85 61 219 247 127 95 95 127 223 255 255 247 255 245 251 247 127 127 255 255 254 0 106 199 255 255 255 255 253 116 
71 95 254 206 0 237 247 255 255 254 239 255 127 255 126 238 0 237 255 255 255 243 126 174 0 238 235 255 255 251 119 92 
199 254 237 127 187 95 223 255 254 239 255 253 247 249 255 127 191 223 223 255 119 191 252 110 175 221 183 245 253 63 255 124 
197 243 247 223 191 247 255 254 239 253 251 125 223 191 223 255 255 255 255 127 255 253 247 219 245 127 93 247 223 223 247 124 
70 0 237 247 127 254 239 255 255 247 159 254 207 255 253 247 255 255 255 255 247 127 211 63 255 219 124 205 255 127 255 124 
71 191 95 223 245 255 253 251 119 255 247 255 245 247 127 223 255 253 254 111 253 119 191 245 246 173 251 215 223 255 247 124 
199 255 253 123 247 223 255 31 255 125 255 125 118 199 253 251 247 255 223 255 127 223 127 127 223 254 0 239 253 118 239 124 
198 238 238 0 239 253 255 253 255 245 223 125 94 239 254 0 238 239 254 238 231 255 251 255 254 111 189 222 111 223 255 124 
199 255 127 187 215 254 199 253 87 255 221 254 207 255 125 187 215 255 255 119 255 255 191 255 253 255 254 207 247 253 249 116 
199 249 255 63 255 125 245 119 221 251 243 223 255 255 246 0 239 247 127 255 255 254 231 255 245 223 255 127 251 250 0 76 
199 191 221 255 253 127 95 222 239 31 191 255 252 111 127 191 94 239 255 255 255 125 255 127 254 207 255 255 191 63 187 84 
199 255 255 223 255 223 255 255 255 255 254 239 255 223 255 255 255 255 255 255 255 255 223 255 255 255 255 255 254 239 62 108 
193 241 241 241 241 241 241 241 241 241 241 241 241 241 241 241 241 241 241 241 241 241 241 241 241 241 241 241 241 241 241 112 
