32
7 31 31 31 31 31 31 31 29 29 31 31 31 31 19 29 27 31 31 31 31 31 31 31 31 31 31 31 31 31 31 28 
199 255 255 255 255 255 245 247 254 207 223 255 255 122 175 254 143 251 255 255 255 255 255 255 255 255 253 253 247 255 255 124 
199 255 255 255 253 123 127 221 243 247 255 255 255 177 255 255 255 188 239 255 255 255 255 255 255 255 248 79 221 251 247 124 
199 255 255 253 250 143 255 127 29 247 241 255 127 191 222 239 253 253 223 255 255 255 255 251 246 237 189 215 254 0 231 124 
199 255 255 254 135 255 255 255 122 79 190 207 255 255 255 255 254 207 223 255 255 255 255 55 255 252 79 221 123 55 220 108 
199 255 255 125 247 255 255 247 191 253 240 231 255 255 255 255 255 255 255 255 255 253 116 239 255 255 221 252 0 239 253 92 
199 255 255 124 201 243 122 239 253 127 31 223 255 253 241 243 247 255 255 255 249 123 223 223 255 255 246 79 157 219 247 92 
199 255 255 255 31 159 191 255 250 199 253 249 247 124 0 0 239 255 253 249 183 158 239 247 251 118 239 253 252 0 237 116 
199 255 255 255 255 255 255 255 62 237 242 0 207 127 22 135 223 255 254 0 207 255 127 251 63 255 255 254 79 159 95 92 
199 255 255 253 247 241 247 255 255 126 0 175 223 124 102 231 255 255 127 183 223 255 255 191 251 255 253 255 255 255 255 124 
199 255 255 121 95 63 222 235 255 127 191 223 253 116 73 255 255 253 120 239 255 255 255 255 179 245 242 204 235 255 255 124 
199 255 255 191 221 243 247 191 251 254 235 255 127 223 159 223 255 254 141 213 249 255 255 127 55 127 159 254 142 237 255 124 
199 255 251 247 126 0 233 244 175 255 189 247 252 233 247 255 255 255 125 209 146 198 238 97 247 255 255 255 255 255 223 124 
199 255 53 251 119 191 30 207 223 247 115 223 253 23 215 255 255 254 110 0 0 237 121 61 215 255 255 255 255 255 255 124 
199 127 254 0 229 251 240 239 126 103 183 255 125 81 247 255 255 254 111 63 159 223 159 93 223 255 255 255 255 255 255 124 
199 255 127 63 223 30 175 223 127 125 247 255 123 23 223 255 255 255 255 255 255 255 253 241 223 255 253 255 255 255 255 124 
199 255 255 255 255 255 255 255 255 127 223 254 46 231 255 255 255 255 251 255 255 253 120 135 213 249 244 206 237 249 255 124 
199 249 245 245 245 245 247 255 255 255 255 255 127 255 255 255 255 255 189 247 255 254 0 79 255 27 215 223 255 159 221 124 
199 60 70 64 71 95 221 245 247 245 247 255 255 255 255 255 255 255 126 199 246 111 189 219 245 55 255 255 255 255 255 92 
197 119 85 61 219 247 127 95 95 127 223 255 255 255 255 255 255 255 127 127 255 255 254 0 110 207 255 255 255 255 253 116 
71 95 254 206 0 237 247 255 255 255 255 255 255 255 255 255 255 255 255 255 255 255 127 191 223 254 235 255 255 251 119 92 
199 254 237 127 191 95 223 255 255 255 255 255 255 255 255 255 255 255 255 255 255 255 255 255 255 255 191 245 253 63 255 124 
197 243 247 223 255 255 255 255 255 253 251 255 255 255 255 255 255 255 255 255 255 253 247 255 255 255 125 247 223 223 255 124 
70 0 237 247 255 255 255 255 255 247 159 255 255 255 255 255 255 255 255 255 255 127 211 255 255 251 124 207 255 255 255 124 
71 191 95 223 245 255 253 251 119 255 255 255 253 247 255 255 255 255 255 255 255 127 191 245 246 175 255 223 255 255 247 124 
199 255 253 123 247 223 255 31 255 253 255 253 118 199 255 255 255 255 255 255 255 255 127 127 223 255 255 255 253 118 239 124 
198 238 238 0 239 255 255 255 255 245 223 125 94 239 255 255 255 255 255 255 255 255 255 255 255 255 253 254 111 223 255 124 
199 255 127 191 223 255 255 253 119 255 221 254 207 255 255 255 255 255 255 255 255 255 255 255 255 255 254 207 247 253 249 116 
199 255 255 255 255 255 253 119 221 251 243 223 255 255 255 255 255 255 255 255 255 255 255 255 255 255 255 127 251 250 0 76 
199 255 255 255 255 255 127 222 239 31 191 255 255 255 255 255 255 255 255 255 255 255 255 255 255 255 255 255 191 63 191 92 
199 255 255 255 255 255 255 255 255 255 255 255 255 255 255 255 255 255 255 255 255 255 255 255 255 255 255 255 255 255 255 124 
193 241 241 241 241 241 241 241 241 241 241 241 241 241 241 241 241 241 241 241 241 241 241 241 241 241 241 241 241 241 241 112 
